# # # # # # # # # # # # # # # # # # # # # # # # # # # # # # # # # E # # #
# # # . . . . # . . . . . # . . . . . . # # # . . . # . . . # . . . # . #
# . C . # # . . . # # # . . . # # # # . . . . . # . . # # . # . # # . . #
# . # # # # # # # # # . # # # . . . . # # . # # # # . # # . # . # . . # # 
# . . . . . . . . . . . . . # # . # # # # # # . . # . . . . . . # . . . #
# # # # # . # # # # # . # . . . . . . . . . . C . # # # # # # # # # # . #
# S . . . . . . . C . . # # # . # . # . # # . . . . . . . . . . . . . . #
# # # # # # # # # # # # # # # # # # # # # # # # # # # # # # # # # # # # #